0000000000000000000000000
0000000000000000000000000
0000000000000000000000000
0000000000000000000000000
0000000000000000000000000
0000000000000000000000000
0000000000000000000000000
0000000000000000000000000
0000000000000000000000000
0000000000000000000000000
0000000000000000000000000
0000000000000000000110000
0000000000000000000000011
0000000000000000000000000
0000000000012001001111111
0000000000111111000000000
0000001110000000000000000
0001110000000000000000000
0001000000000000000000000
1111111000000000000000000