00000000000000000000000000000000000000000000000000000000000000000000000000000000000000000000000000000000000000000000000000000000000000000000000000000000000000000000000000000000000000000000000000000000000000
00000000000000000000000000000000000000000000000000000000000000000000000000000000000000000000000000000000000000000000000000000000000000000000000000000000000000000000000000000000000000000000000000000000000000
00000000000000000000000000000000000000000000000000000000000000000000000000000000000000000000000000000000000000000000000000000000000000000000000000000000000000000000000000000000000000000000000000000000000000
00000000000000000000000000000000000000000000000000000000000000000000000000000000000000000000000000000000000000000000000000000000000000000000000000000000000000000000000000000000000000000000000000000000000000
00000000000000000000000000000000000000000000000000000000000000000000000000000000000000000000000000000000000000000000000000000000000000000000000000000000000000000000000000000000000000000000000000000000000000
00000000000000000000000000000000000000000000000000000000000000000000000000000000000000000000000000000000000000000000000000000000000000000000000000000000000000000000000000000000000000000000000000000000000000
00000000000000000000000000000000000000000000000000000000000000000000000000000000000000000000000000000000000000000000000000000000000000000000000000000000000000000000000000000000000000000000000000000000000000
00000000000000000000000000000000000000000000000000000000000000000000000000000000000000000000000000000000000000000000000000000000000000000000000000000000000000000000000000000000000000000000000000000000000000
00000000000000000000000000000000000000000000000000000000000000000000000000000000000000000000000000000000000000000000000000000000000000000000000000000000000000000000000000000000000000000000000000000000000000
00000000000000000000000000000000000000000000000000000000000000000000000000000000000000000000000000000000000000000000000000000000000000000000000000000000000000000000000000000000000000000000000000000000000000
00000000000000003000000000000000000000000000000000000000000000000000000000111111110001113000000000000003000000000001110000133100000000000000000000000000000000000000000000000000000000AA0000000000000000000000
0000000000000000000000000000000000000000000000000000000000000000000000000000000000000000000000000000000000000000000000000000000000000000000000000000000000000000000000000000000000000AAA0000000000000000000000
000000000000000000000000000000000000000000000000000000000000000000000000000000000000000000000000000000000000000000000000000000000000000000000000000000000000000000000000000000000000AAAA0000000000000000000000
00000000000000000000000000000000000000000000000000000000003000000000000000000000000000000000000000000000000000000000000000000000000000000000000000000000000000000000000000000000000AAAAA0000000000000000000000
00000000003000131310000000000000000000000000000000000000000000000000000131000000000000003000001300003003003000001000000000011000000A00A0000000000AA00A0000000000001131000000000000AAAAAA0000000000000000000000
0000000000000000000000000000000000000000000000000000000000000000000000000000000000000000000000000000000000000000000000000000000000AA00AA00000000AAA00AA00000000000000000000000000AAAAAAA0000000000000000000000
000000000000000000000000000000000000000000000000000000000000000000000000000000000000000000000000000000000000000000000000000000000AAA00AAA000000AAAA00AAA000000000000000000000000AAAAAAAA0000000000000000000000
00000000000006000004007000000000800000009000000000090000000000000000000000000000000000000000000000000000000000000000000000000000AAAA00AAAA0000AAAAA00AAAA0000700000000000000070AAAAAAAAA00000000A0000000000000
22222222222222222222222222222222222222222222222222222222222222200222222222222222000222222222222222222222222222222222222222222222222222222222222222200222222222222222222222222222222222222222222222222222222222
22222222222222222222222222222222222222222222222222222222222222200222222222222222000222222222222222222222222222222222222222222222222222222222222222200222222222222222222222222222222222222222222222222222222222