000000000000000000000000000000000000000000000000000000000000000000000000000000000000000000000000000000000000000000000000000000000000000000000000000000000000000000000000000000000000000000000000000000000000000000
000000000000000000000000000000000000000000000000000000000000000000000000000000000000000000000000000000000000000000000000000000000000000000000000000000000000000000000000000000000000000000000000000000000000000000
000000000000000000000000000000000000000000000000000000000000000000000000000000000000000000000000000000000000000000000000000000000000000000000000000000000000000000000000000000000000000000000000000000000000000000
000000000000000000000000000000000000000000000000000000000000000000000000000000000000000000000000000000000000000000000000000000000000000000000000000000000000000000000000000000000000000000000000000000000000000000
000000000000000000000000000000000000000000000000000000000000000000000000000000000000000000000000000000000000000000000000000000000000000000000000000000000000000000000000000000000000000000000000000000000000000000
000000000000000000000000000000000000000000000000000000000000000000000000000000000000000000000000000000000000000000000000000000000000000000000000000000000000000000000000000000000000000000000000000000000000000000
000000000000000000000000000000000000000000000000000000000000000000000000000000000000000000000000000000000000000000000000000000000000000000000000000000000000000000000000000000000000000000000000000000000000000000
000000000000000000000000000000000000000000000000000000000000000000000000000000000000000000000000000000000000000000000000000000000000000000000000000000000000000000000000000000000000000000000000000000000000000000
000000000000000000000000000000000000000000000000000000000000000000000000000000000000000000000000000000000000000000000000000000000000000000000000000000000000000000000000000000000000000000000000000000000000000000
000000000000000000000000000000000000000000000000000000000000000000000000004040000000000000000000000000000000000000000000000000000000000000000000000000000000000000000000000000000000000000000000000000000000000000
0000000000000000B00000000000000000000000000000000000000000000000000000000011111111000111B0000000000000030000000000011100001BB100000000000000000000000000000000000000000000000000000000AA00000000000000000000000000
0000000000000000000000000000000000000000000000000000000000000000000000000000000000000000000000000000000000000000000000000000000000000000000000000000000000000000000000000000000000000AAA00000000000000000000000000
000000000000000000000000000000000000000000000000000000000000000000000000000000000000000000000000000000000000000000000000000000000000000000000000000000000000000000000000000000000000AAAA00000000000000000000000000
00000000000000000000000000000000000000000000000000000000003000000000000000000000000000000000000000000000000000000000000000000000000000000000000000000000000000000000000000000000000AAAAA00000000000000000000000000
0000000000B000131B1000000000000000000000000000000000000000000000000000013100000000000000B00000130000B00B00B000001000000000011000000A00A0000000000AA00A00000000000011B1000000000000AAAAAA00000000000000000000000000
0000000000000000000000000000000000000000000000000000000000000000000000000000000000000000000000000000000000000000000000000000000000AA00AA00000000AAA00AA00000000000000000000000000AAAAAAA00000000000000000000000000
000000000000000000000000000000000000000000000000000000000000000000000000000000000000000000000000000000000000000000000000000000000AAA00AAA000000AAAA00AAA000000000000000000000000AAAAAAAA00000000C00000000000000000
00000000000000004000007000000000840000009000440000090000000006000000000000000000000000000004400000006000000044000000004404400000AAAA00AAAA0000AAAAA00AAAA0000700000000000440070AAAAAAAAA00000000A00000000000000000
222222222222222222222222222222222222222222222222222222222222222002222222222222220002222222222222222222222222222222222222222222222222222222222222222002222222222222222222222222222222222222222222222222222222222222
222222222222222222222222222222222222222222222222222222222222222002222222222222220002222222222222222222222222222222222222222222222222222222222222222002222222222222222222222222222222222222222222222222222222222222